██████████████████████████████████████████████████████████████████████████████████████████████████████████████████████
██████████████████████████████████████████████████████████████████████████████████████████████████████████████████████
██████████████████████████████████████████████████████████████████████████████████████████████████████████████████████
███████░░░░░░░░░░░░░░░░░░░░░░░░░░░░░░░░░░░░░░░░░░░░░░░░░░░░░░░░░░░░░░░░░░░░░░░░░░░░░░░░░░░░░░░░░░░░░░░░░░░░░░░░███████
███████░░░░░░░░▒▒░░░░░░░░░░░░░░░░░░░░░░░░░░░░░░░░░░░░░░░░░░░░░░▒▒░░░░░░░░░░░░░░░░░░░░▒▒▒▒░░░░░░░░░░▒▒░░░░░░░░░░███████
██████████████████████████████████████████████████████████████████████████████████████████████████████████████████████
██████████████████████████████████████████████████████████████████████████████████████████████████████████████████████
█████████░░░░░░░░░░░░▒▒▒▒░░██████▓▓░░████▒▒░░░░░░░░▓▓████████░░░░░░░░░░██▓▓░░▒▒██████░░▒▒██▓▓░░░░░░▒▒▓▓███████████████
███████▓▓░░▒▒▒▒▓▓▒▒▒▒░░░░▒▒▓▓████▒▒▒▒▓▓██░░▒▒▒▒▒▒░░▓▓██████▓▓▒▒▒▒▒▒▒▒░░▓▓▒▒▓▓▒▒▓▓████░░░░██▒▒▓▓▒▒▒▒▓▓▒▒▓▓█████████████
█████████████░░▒▒▓▓▓▓██░░▒▒██████▒▒▒▒▓▓██░░░░▓▓██████████████▒▒░░▓▓██████▓▓▒▒▒▒░░████░░░░██▒▒▒▒▓▓▓▓▒▒▒▒░░█████████████
█████████████░░░░██████░░▒▒▓▓████▒▒▒▒▓▓██▒▒░░████████████████▒▒▒▒████████▓▓▓▓░░▒▒▓▓██░░░░██▒▒▓▓██████▒▒▓▓▒▒███████████
█████████████░░▒▒██████░░▒▒▓▓▓▓▓▓▒▒▒▒▓▓██░░░░▓▓▓▓████████████▒▒▒▒▓▓▓▓████▓▓▓▓░░▒▒░░██░░░░██▒▒▒▒▓▓████▓▓▒▒░░███████████
█████████████░░▒▒██████░░▓▓▒▒▒▒░░▒▒▒▒▓▓██░░▒▒▒▒▒▒░░████████▓▓▒▒▒▒▒▒▒▒░░██▓▓▒▒▒▒░░░░▓▓░░░░██▒▒▒▒▓▓██████▒▒░░███████████
█████████████▒▒▒▒██████░░▒▒░░░░▒▒░░▒▒▓▓██░░░░░░░░▒▒██████████▒▒░░░░░░▒▒██▓▓▒▒▒▒▒▒▓▓▒▒░░░░██▒▒▓▓▒▒██████▒▒░░███████████
█████████████░░▒▒██████░░▒▒▓▓████▒▒▒▒▓▓██▒▒░░████████████████▒▒▒▒████████▓▓▓▓▒▒██░░░░░░░░██░░▒▒██████▓▓▒▒░░███████████
█████████████░░▒▒██████▒▒▒▒██████▓▓▒▒▓▓██▒▒░░████████████████▓▓▒▒████████▓▓▓▓▒▒██░░▒▒░░░░██▒▒▒▒▓▓████▒▒▓▓▒▒███████████
█████████████░░▒▒██████░░▒▒▓▓████▒▒▓▓▓▓██░░░░▓▓▓▓████████████▒▒▒▒▓▓▓▓▓▓██▓▓▒▒▒▒██▓▓▒▒▓▓░░██▒▒▒▒▓▓▓▓▒▒▒▒░░█████████████
█████████████░░▒▒██████░░▓▓██████▒▒▒▒▓▓██░░▒▒▒▒▒▒▒▒▒▒████████▒▒▓▓▒▒▒▒░░▓▓▒▒▒▒▒▒████░░▓▓░░██▒▒▓▓▒▒▒▒▓▓░░▓▓█████████████
█████████████▒▒░░██████▓▓░░██████▓▓░░████▒▒▒▒▒▒▒▒░░▓▓████████▒▒▒▒▒▒▒▒░░██▓▓░░▓▓██████░░▓▓██▓▓░░▒▒░░▒▒█████████████████
██████████████████████████████████████████████████████████████████████████████████████████████████████████████████████
███████▓▓▓▓▓▓▓▓▓▓▓▓██▓▓▓▓▓▓▓▓▓▓▓▓▓▓░░▓▓▓▓▒▒▓▓▓▓▓▓▓▓▓▓▓▓▓▓▓▓▓▓░░░░░░░░░░▓▓▓▓▓▓▓▓▓▓▓▓▓▓░░▓▓▓▓▓▓▓▓▓▓▓▓▓▓▓▓▓▓▓▓▓▓▓▓███████
███████░░▓▓▒▒▒▒▒▒▓▓▓▓▓▓▒▒▒▒▒▒▒▒▒▒▒▒▒▒▒▒▓▓▒▒▒▒▓▓▒▒▓▓▓▓▓▓▓▓▓▓▓▓▒▒▒▒▒▒▒▒▓▓▓▓▒▒▒▒▒▒▒▒▒▒▒▒▒▒▒▒▓▓▒▒▒▒▒▒▓▓▓▓▒▒▒▒▒▒▒▒░░███████
███████▒▒▒▒▒▒▒▒▒▒▒▒▒▒▒▒▒▒▒▒▒▒░░░░▒▒▒▒▒▒▒▒▒▒▒▒▒▒▒▒▒▒▒▒▒▒▒▒▒▒▒▒▒▒▒▒▒▒▓▓▒▒▒▒▒▒▒▒▒▒▒▒▒▒▒▒▒▒░░▒▒▒▒▓▓▓▓░░▒▒▒▒▒▒▒▒▒▒▒▒███████
██████████████████████████████████████████████████████████████████████████████████████████████████████████████████████
██████████████████████████████████████████████████████████████████████████████████████████████████████████████████████
██████████████████████████████████████████████████████████████████████████████████████████████████████████████████████